R 1280 720
Falla ./textures/wood.xpm
SO ./textures/mossy.xpm
WE ./textures/redbrick.xpm
EA ./textures/stone.xpm

S ./textures/table.xpm
F 255,255,255
C 84,240,235

1 1 1 1 1 1 1 1 1 1 1 1 1 1 1
1 0 0 0 0 0 0 0 0 0 0 0 0 0 1
1 0 N 0 2 0 0 0 0 2 0 0 0 0 1
1 0 0 0 0 0 0 0 0 0 0 3 0 0 1
1 0 0 0 0 0 0 0 0 0 0 0 0 0 1
1 0 0 1 1 1 0 1 1 1 0 1 1 0 1
1 0 0 1 0 0 0 0 0 1 0 1 1 0 1
1 0 0 1 0 0 0 0 0 1 0 0 0 0 1
1 0 0 1 1 1 0 0 0 1 0 0 0 0 1
1 0 0 0 0 1 0 0 0 1 0 0 0 0 1
1 0 0 0 0 1 0 0 0 1 0 2 0 0 1
1 0 0 0 0 1 0 0 0 1 0 0 0 0 1
1 0 0 0 0 1 1 1 0 1 0 0 0 0 1
1 0 0 0 0 0 0 0 0 1 0 0 0 0 1
1 0 0 0 0 0 1 1 0 0 0 1 1 0 1
1 1 1 1 1 1 1 1 1 1 1 1 1 1 1