9.ox
.....oooo
.ooo....
.o.oo..oo
o..o..o.o
.o......o
ooo..o.oo
.o.....o.
..o......
...o.o.oo
