8.ox
o..o....
........
o..ooo..
.......o
.o.oo..o
..ooooo.
o...o...
........
